11111
1ECC1
11111
1C001
1P001
11111