111111111111111111111111
1C1000000000000000000001
100100000000000001110011
110111110000010100000011
100011000011000100101001
100000000000111000000011
100000000000000000011111
1E0CC0000000000P00010001
111111111111111111111111