11111111111
1P0C0C000E1
100C0100001
100100C0001
10000C00001
10000000001
10001000001
10000000001
11111111111