11111 11111
1E001 1E001
1C001 1C001
1C001 1C001
1P0C1 1P0C1
11111 11111