11111
1E101
11101
1C001
1P001
11111